bin/forest_tiles.png
32 32
4
5 8
0 0
0 1
14 7
21 15
0 0 2 2 2 1 2 2 2 2 2 2 1 0 0 0 3 3 3 3 0
0 1 1 1 1 1 1 1 1 1 2 2 3 0 0 0 0 0 3 3 0
0 1 1 1 0 1 1 1 1 1 1 2 3 3 3 3 3 3 3 3 1
0 1 1 1 0 1 1 0 0 0 1 2 2 2 3 1 1 3 3 3 1
0 0 0 0 0 1 1 1 1 0 1 1 2 2 0 1 1 1 3 3 1
0 0 0 0 0 1 2 2 1 1 1 1 0 0 0 0 0 1 3 3 1
0 0 0 0 0 0 2 2 1 1 2 1 1 1 2 2 0 1 1 1 3
0 0 0 0 0 2 1 1 1 3 3 3 1 1 1 1 1 1 1 1 3
0 0 0 0 2 2 1 1 1 3 3 1 2 0 0 1 1 1 1 1 1
0 0 0 0 2 2 1 1 1 0 1 2 2 1 0 1 1 2 0 2 2
1 0 0 0 0 2 0 0 0 0 0 1 1 1 0 1 1 2 0 2 2
1 0 0 0 0 0 0 2 2 1 1 1 0 0 0 1 2 1 0 2 2
1 1 1 1 1 1 0 1 1 1 1 1 0 1 2 2 2 1 1 2 2
1 1 1 1 1 1 0 1 1 1 1 1 2 2 1 0 0 0 0 2 1
1 1 1 1 1 1 1 1 1 1 1 2 2 1 1 1 1 1 2 2 1